SO ./pics/rose.xpm
WE ./pics/4.xpm
NO ./pics/6.xpm
EA ./pics/werda.xpm
     C  255,204,178
      F    246,231,135
     1111111111111111111
1111100000000000001
100W00000000000000011
100000000001000000011            
10000001010100000011
1000000000100000001
1000000000000000001
111111110111111111
111111110111111111
1000000000000000001
1000000000000000001
1111111111111111111