SO ./pics/Ginko.xpm
WE ./pics/Dressing-Unit.xpm
NO ./pics/Lotus-Texture.xpm
EA ./pics/Wallpaper-Designs-For-Walls.xpm
      C  135,206,235
       F    212,198,186
111111111111111
1000000000000W1
101111111111101
100000000000001
101011111110101
101010000010101
101010111010101
101010111010101
101010111010101
101010000010101
101011111110101
101000000000101
101111111111101
100000000000001
111111111111111