SO ./pics/Ginko.xpm
WE ./pics/Dressing-Unit.xpm
NO ./pics/Lotus-Texture.xpm
EA ./pics/Wallpaper-Designs-For-Walls.xpm
      C  135,206,235
       F    201,191,185

        1111111111111111111111111
        1100000000011000000000001
        101100000111000000S000001
        1001000000000000000000001
111111111011000001110000000000001
100000000011000001110111111111111
1111111111011111111101111111
1111111111111111 1110111111111
11110111111111011100000010001
11110111111111011101010010001
11000000110101011100000010001
10000000000000000000000010001
1000000000000000110101001000111  
1100000111010101111101111000111
11110111 1110101 101111010001
11111111 1111111 111111111111