NO    ./path_to_the_north_texture

F             0,200,120
WE ./path_to_the_west_texture

C  20,205,62


EA ./path_to_the_east_texture

SO     ./path_to_the_south_texture


   
        1111111111111111111111111
        1000000000000000000000001    
     1110000000000110000000011111
    111111111111111111111111
    1111111111111111111111111
    11101100000111000000000001111
111100100000000000000000001111111
111111111011000001110000000000001
10000000001101000111011111111111111
1111111111111111111 1111 
11111111111111111
11111111S11111111                       
11111111111111111111111111111                    11111
111111111111011100000010001                   
1111111111111011101010010001        
11000000110101011100000010001        
1000000000000001100000010001
1000000000000011010100111111
1111111111111111111111111111
1000000010000000000000000001
1100010011101110111110111100111
111101101 11100101 101111010001
111111111 1111111 111111111111